Columns: 25
Rows: 20
2300000023000000023000000
4500000045000000045000000
0000000023000000000000000
0000000045232323232300000
0023000000454545454500000
0045000000000230000002323
0023000232300450000004545
0045000454500000002300000
2323232302323000004500000
4545454504545000002300000
0000000000000000004523000
0000000000000000000045000
0023000002300000230023000
0045002304500000450045000
0023004500000000230000230
0045000000000000450000450
0023000230023232300000230
0045000450045454500000450
0000000230000002300330000
0000000450000004500450000
